SSSSSSSSSSSSSSSSSSSSSSSSSSSSSSSSSSSSSSSSSSSSSSSSSSSSSSSSS
>
--------
SSSSSSSS
--------
--------
----HHHH
--------
--------
-UUUUUUU
NNNHHNNN
>
--------
SSSSSSSS
SSSSSSSS
SSSSSSSS
SSSSSSSS
SSSSSSSS
SSSSSSSS
>
UHNSUHNS
UHNSUHNS
UHNS----
----UHNS
--------
--------
U---U---
>
UUUUUUUU
--------
SSSSSSSS
--------
--------
--------
HHHHHHHH
>
--------
--------
--------
SSSSSSSS
SSUUUUUU
>